Danh sách quẻ đã xử lý:
- QUẺ BÁC - QUE_BAC
- QUẺ BÍ - QUE_BI_2
- QUẺ BĨ - QUE_BI
- QUẺ CHẤN - QUE_CHAN
- QUẺ CÁCH - QUE_CACH
- QUẺ CẤN - QUE_CAN
- QUẺ CẤU - QUE_CAU
- QUẺ CỔ - QUE_CO
- QUẺ DI - QUE_DI
- QUẺ DỰ - QUE_DU
- QUẺ GIA NHÂN - QUE_GIA_NHAN
- QUẺ GIẢI - QUE_GIAI
- QUẺ HOÁN - QUE_HOAN
- QUẺ HÀM - QUE_HAM
- QUẺ HẰNG - QUE_HANG
- QUẺ KHIÊM - QUE_KHIEM
- QUẺ KHUÊ - QUE_KHUE
- QUẺ KHÔN - QUE_KHON
- QUẺ KIỀN - QUE_KIEN
- QUẺ KÝ TẾ - QUE_KY_TE
- QUẺ LY - QUE_LY_2
- QUẺ LÂM - QUE_LAM
- QUẺ LÝ - QUE_LY
- QUẺ LỮ - QUE_LU
- QUẺ MINH DI - QUE_MINH_DI
- QUẺ MÔNG - QUE_MONG
- QUẺ NHU - QUE_NHU
- QUẺ PHONG - QUE_PHONG
- QUẺ PHỆ HẠP - QUE_PHE_HAP
- QUẺ PHỤC - QUE_PHUC
- QUẺ QUI MUỘI - QUE_QUI_MUOI
- QUẺ QUÁN - QUE_QUAN
- QUẺ QUẢI - QUE_QUAI
- QUẺ SƯ - QUE_SU
- QUẺ THÁI - QUE_THAI
- QUẺ THĂNG - QUE_THANG
- QUẺ TIẾT - QUE_TIET
- QUẺ TIỂU QUÁ - QUE_TIEU_QUA
- QUẺ TIỂU SÚC - QUE_TIEU_SUC
- QUẺ TIỆM - QUE_TIEM
- QUẺ TRUNG PHU - QUE_TRUNG_PHU
- QUẺ TRUÂN - QUE_TRUAN
- QUẺ TÙY - QUE_TUY
- QUẺ TẤN - QUE_TAN
- QUẺ TẬP KHẢM - QUE_TAP_KHAM
- QUẺ TỈNH - QUE_TINH
- QUẺ TỐN - QUE_TON_2
- QUẺ TỒN - QUE_TON
- QUẺ TỤNG - QUE_TUNG
- QUẺ TỤY - QUE_TUY
- QUẺ TỴ - QUE_TY
- QUẺ VÔ VỌNG - QUE_VO_VONG
- QUẺ VỊ TẾ - QUE_VI_TE
- QUẺ ÍCH - QUE_ICH
- QUẺ ĐOÁI - QUE_DOAI
- QUẺ ĐẠI HỮU - QUE_DAI_HUU
- QUẺ ĐẠI QUÁ - QUE_DAI_QUA
- QUẺ ĐẠI SÚC - QUE_DAI_SUC
- QUẺ ĐẠI TRÁNG - QUE_DAI_TRANG
- QUẺ ĐỈNH - QUE_DINH
- QUẺ ĐỒNG NHÂN - QUE_DONG_NHAN
- QUẺ ĐỘN - QUE_DON